Share and prepare !	Sharing and preparing!	0
Mall owners and commercial developers will be hit particularly hard .	Mall owner and commercial developer will be hit hard.	0
Why do you feel a need to talk about this publicly ?	Why do you feel the need to speak about this publicly?	0
The thought of Africans in space is laughable .	The thoughts of the Africans in space are ridiculous.	1
Maybe try a badger instead ?	Maybe you should try a badger.	0
Susan	SUSAN is	0
Here are a few of my favourites by Dr. Pierce !	This is one of Dr. Pierce’s favourites.	0
FL that 's an old photo of last year .	This is an old photo from last year.	0
I shoot a `` souped up '' first year Ruger Old Army .	I’m going to shoot a “sudden” first year of Ruger’s old army.	0
The BNP gained three times the votes it had in last election .	The BNP won three times as many votes as it had in the last elections.	0
that is the sadest news i have ever heard in my entire life , ireland not a white country. its like saying the world is ending	That’s the saddest news I’ve ever heard in my whole life, Ireland is not a white country.	1
White people - report immediately to Californian University for `` re-education '' .	White men - immediately seek "re-education" at the University of California.	0
The census results will be released next year .	The results of the census will be published next year.	0
PM me !	I PM you!	0
I appreciate it ... thanx .	Thank you very much, thanx.	0
The jew Alan Fishman , 49 , of Brooklyn , NY , was arrested along with the jew Daniel Ledven , 37 , of Cresskill , N.J. , on securities and wire fraud charges in a scheme that swindled investors out of $ 20 million .	49-year-old Jew Alan Fishman, from Brooklyn, New York, was arrested along with 37- year-old Daniel Redven, from Cressskill, for a plan to deceive investors for $20 million in securities and wire fraud.	0
I'm looking for a white enchanting girl , That I can have by my side , . through the thick filth that us americans go through and the best of times aswell .	I am looking for a white attractive girl to have on my side, through the thick dirt we Americans experience, and through the best times.	1
Help me send a message to Obama : https : //petitions.whitehouse.gov/pet ... istan/SZP82fbc https : //petitions.whitehouse.gov/pet ... ation/PLzLzpnc https : //petitions.whitehouse.gov/pet ... -iran/Gs7L50Kv https : //petitions.whitehouse.gov/pet ... h-irs/s8XQx9Hs https : //petitions.whitehouse.gov/pet ... tates/nzjYDlGM	Please help me to send a message to Mr. Obama: https: //petitions.whitehouse.gov/pet... istan/SZP82fbc https: /petitions.whiteHouse.gov /pet... action/PLzLzpnc https : //petition.Whitehous.gov... -iran/Gs7L50Kv https://petitions	0
- = Wulfi = -	Wulf = -	0
https : //www.facebook.com/pages/Boyco ... 85159441543213 Worthwhile Canadian Initiative : Dumb men commercials err ... why not dumb black men , dumb black women , dumb Asians ?	https: //www.facebook.com/pages/Boyco... 85159441543213 Valuable Canadian Initiative: Idiot Men Advertising Err... Why Idiot Black Men, Idiot black Women, Idiots Asian Men?	0
I remember going on them when I was a young boy .	I remember following them when I was young.	0
Eldritch and myself went early to the harbour , but all the boats were cancelled on account of rough weather .	Eldritch and I went to the port early, but all boats were cancelled due to the harsh weather.	0
Then again it 's the same people who told all students living on campus they had three hours to vacate and go home .	Then they are the same people who told all the students who live on campus that they have three hours to spend their holidays and go home.	0
2508	of 508.	0
1. good news , especially that of the gospel [ < A.S. god spel , good tidings ] ; 2. one who carries the gospel news ; an evangelist : Evangel , Archaic , any one of the four Gospels. [ < Gk. euaggelion , the gospel < eu , well + aggellos , a messenger ]	1. good news, especially that of the Gospel; 2. one that brings the evangelization; a evangelist: Evangel, Archaic, one of the four Gospels.	0
Does n't sound like I 'm missing much anyway .	It doesn’t sound like I’ve missed it a lot anyway.	0
I guess the Yonge St retail district will be smashed and looted .	I think Yonge St’s retail district will be crushed and looted.	1
Please do not hurt those fine masons first they have to hand over the maps on the locations of the cupped oil wells .	Please do not hurt that great mason they must first pass the map at the location of the cup oil well.	0
That s how I and my friends were for awhile we have the same beliefs but knew nothing of the WN movement or WN until one day I was searching the web and came across a white nationalist site and there was a link to stormfront on it and from there I told my friends about it and now we will try and spread the word !	That’s what I and my friends had for a while, we had the same beliefs but didn’t know about the WN movement or WN until one day I was searching the net and encountered a white nationalist website and had a link to the storm frontline from where I told my friends that now we’re going to try to spread the word!	0
Victims of Illegal Alien Crime http://www.voiac.org/report.php REPORT A CRIME .	Victims of the illegal crime of foreigners http://www.voiac.org/report.php REPORT A CRIME.	0
YouTube - & #x202a ; Unruly Teens wrecking a Dunkin Donuts at 75 christopher street in manhattan & #x202c ; & rlm ;	YouTube - & #x202a ; Unrighteous teenagers shoot Dunkin Donuts on the 75 Christopher Street in Manhattan & rlm ;	0
I can care less who 's better then who .	I care less about who is better than who.	0
